""
INDEX__SECTION	INDEX_SECTION
houdini.hdalibrary	houdini.hdalibrary
Driver_1pbrt	Driver/pbrt
Driver_1pbrtarchive	Driver/pbrtarchive
Vop_1pbrt__spectrum	Vop/pbrt_spectrum
Vop_1pbrt__camera__environment	Vop/pbrt_camera_environment
Vop_1pbrt__camera__perspective	Vop/pbrt_camera_perspective
Vop_1pbrt__camera__orthographic	Vop/pbrt_camera_orthographic
Vop_1pbrt__camera__realistic	Vop/pbrt_camera_realistic
Vop_1pbrt__sampler__02sequence	Vop/pbrt_sampler_02sequence
Vop_1pbrt__sampler__halton	Vop/pbrt_sampler_halton
Vop_1pbrt__sampler__maxmindist	Vop/pbrt_sampler_maxmindist
Vop_1pbrt__sampler__random	Vop/pbrt_sampler_random
Vop_1pbrt__sampler__sobol	Vop/pbrt_sampler_sobol
Vop_1pbrt__sampler__stratified	Vop/pbrt_sampler_stratified
Vop_1pbrt__film__image	Vop/pbrt_film_image
Vop_1pbrt__filter__box	Vop/pbrt_filter_box
Vop_1pbrt__filter__gaussian	Vop/pbrt_filter_gaussian
Vop_1pbrt__filter__triangle	Vop/pbrt_filter_triangle
Vop_1pbrt__filter__mitchell	Vop/pbrt_filter_mitchell
Vop_1pbrt__filter__sinc	Vop/pbrt_filter_sinc
Vop_1pbrt__integrator__path	Vop/pbrt_integrator_path
Vop_1pbrt__integrator__directlighting	Vop/pbrt_integrator_directlighting
Vop_1pbrt__integrator__bdpt	Vop/pbrt_integrator_bdpt
Vop_1pbrt__integrator__mlt	Vop/pbrt_integrator_mlt
Vop_1pbrt__integrator__sppm	Vop/pbrt_integrator_sppm
Vop_1pbrt__integrator__whitted	Vop/pbrt_integrator_whitted
Vop_1pbrt__integrator__ao	Vop/pbrt_integrator_ao
Vop_1pbrt__integrator__volpath	Vop/pbrt_integrator_volpath
Vop_1pbrt__accelerator__bvh	Vop/pbrt_accelerator_bvh
Vop_1pbrt__accelerator__kdtree	Vop/pbrt_accelerator_kdtree
Vop_1pbrt__light__distant	Vop/pbrt_light_distant
Vop_1pbrt__light__goniometric	Vop/pbrt_light_goniometric
Vop_1pbrt__light__infinite	Vop/pbrt_light_infinite
Vop_1pbrt__light__point	Vop/pbrt_light_point
Vop_1pbrt__light__projection	Vop/pbrt_light_projection
Vop_1pbrt__light__spot	Vop/pbrt_light_spot
Vop_1pbrt__arealight__diffuse	Vop/pbrt_arealight_diffuse
Vop_1pbrt__material__fourier	Vop/pbrt_material_fourier
Vop_1pbrt__material__disney	Vop/pbrt_material_disney
Vop_1pbrt__material__glass	Vop/pbrt_material_glass
Vop_1pbrt__material__hair	Vop/pbrt_material_hair
Vop_1pbrt__material__translucent	Vop/pbrt_material_translucent
Vop_1pbrt__material__substrate	Vop/pbrt_material_substrate
Vop_1pbrt__material__plastic	Vop/pbrt_material_plastic
Vop_1pbrt__material__metal	Vop/pbrt_material_metal
Vop_1pbrt__material__uber	Vop/pbrt_material_uber
Vop_1pbrt__material__mix	Vop/pbrt_material_mix
Vop_1pbrt__material__mirror	Vop/pbrt_material_mirror
Vop_1pbrt__material__matte	Vop/pbrt_material_matte
Vop_1pbrt__material__subsurface	Vop/pbrt_material_subsurface
Vop_1pbrt__material__kdsubsurface	Vop/pbrt_material_kdsubsurface
Vop_1pbrt__texture__constant	Vop/pbrt_texture_constant
Vop_1pbrt__texture__scale	Vop/pbrt_texture_scale
Vop_1pbrt__texture__mix	Vop/pbrt_texture_mix
Vop_1pbrt__texture__bilerp	Vop/pbrt_texture_bilerp
Vop_1pbrt__texture__imagemap	Vop/pbrt_texture_imagemap
Vop_1pbrt__texture__uv	Vop/pbrt_texture_uv
Vop_1pbrt__texture__dots	Vop/pbrt_texture_dots
Vop_1pbrt__texture__checkerboard	Vop/pbrt_texture_checkerboard
Vop_1pbrt__texture__fbm	Vop/pbrt_texture_fbm
Vop_1pbrt__texture__wrinkled	Vop/pbrt_texture_wrinkled
Vop_1pbrt__texture__windy	Vop/pbrt_texture_windy
Vop_1pbrt__texture__marble	Vop/pbrt_texture_marble
Vop_1pbrt__texture__ptex	Vop/pbrt_texture_ptex
Vop_1pbrt__medium	Vop/pbrt_medium
Vop_1pbrt__material__none	Vop/pbrt_material_none
